--------
||||||||
@_____++
+_++_+++
+_++++++