................
................
................
.........=====..
................
....===.........
................
@............+++
++.+++..++++++++
++++++++++++++++
