|              |
|              |
|              |
|        ===== |
|              |
|   ===        |
|              |
@____________+++
++_+++__++++++++
++_+++++++++++++