..............*..........
............-............
.........................
............|............
..........=====..........
....................==...
.....===......|.....-....
@.....-......++++.+++++++
++.+++..+++++++++.+++++++
++.++++++++++++++.+++++++