--------
||||||||
______++
+_++_+++
+_++++++