..............*..........
............-............
.........................
............|............
..........=====..........
.....................=...
.......=......|.....-....
@.....-......++++..++++++
++..++..+++++++++..++++++
++..+++++++++++++..++++++