..............*..........
............-............
.........................
............|............
..........=====..........
.....................=...
.......=......|.....-....
@.....-......++++.+++++++
++.+++..+++++++++.+++++++
++.++++++++++++++.+++++++