.........................
.........................
.........................
............-............
..........=====.....|....
...................===...
.....===.......-.........
@...|........++++.+++++++
++.+++..+++++++++.+++++++
++.++++++++++++++.+++++++