..............*..........
............-............
.........................
............|............
..........=====..........
....................==...
.......===....|....-.....
@....-.......++++.+++++++
++.+++..+++++++++.+++++++
++.++++++++++++++.+++++++