..............*..........
.........................
.........................
.............-.|.........
............=====........
......................-..
..+......=.......|.......
@++..-.........+++....|..
+++.....++++++++++..+++++
+++..+..++++++++++..+++++