................
................
................
.........=====..
................
................
....===.........
.............+++
++.+++..++++++++
++.+++++++++++++