................
................
................
.........=====..
................
................
.....===........
.............+++
++.+++..++++++++
++.+++++++++++++