.........................
.........................
.........................
.........................
..........=====..........
...................===...
.....===.................
@............++++.+++++++
++.+++..+++++++++.+++++++
++.++++++++++++++.+++++++
-------------------------