..............*..........
............-............
.........................
............|............
..........=====..........
....................==...
.....===...........|-....
@...|.-......++++.+++++++
++.+++..+++++++++.+++++++
++.++++++++++++++.+++++++