..............*..........
.........................
....................-....
...-........====.........
......=.............|....
...................==....
........=..............++
@.|..........+++..++...++
++++++||||++++++..+++.-++
++++++++++++++++..+++++++