..............*..........
.........................
....................-....
...-........====.........
......=.............|....
...................==....
........=..............++
@.|.|........++++.+++..++
++++++||||+++++++.++++-++
+++++++++++++++++.+++++++