..............*..........
.........................
.........................
.............-.|.........
............=====........
......................-..
.........=.......|.......
@.+..-.........+++....|..
+++.....++++++++++..+++++
+++..+..++++++++++..+++++